1111111111111111
1P00000001000001
1000E00000B10101
10000E00100C0001
1000000000000001
1111111111111111