1111111111111111
1P0C000C01000001
1000E000000001C1
1111111111111111