1111111111111111
1PEC000C01000001
1000E000000001C1
1111111111111111