1111111111111111
100000C001000001
1P000100C00001E1
1111111111111111
