1111111111111111
1000000C01000001
1P0E010000000111
1111111111111111
