1111111111111111111111111111111111
1E000P000000000100000100C000000001
1010010100100000101001000000010101
1111111111111111111111111111111111
1111111111111111111101111111111111