11111111111111111111
1E1001000001000000C1
10100101100010100101
101E00C0P1000C000101
10100101000C00010C01
101001000000000E0001
10100101101010010101
10100C00CC0001100001
10101011100100000CC1
1010100E010010CC1001
1010010100100C000101
10100C01000C00010C01
10100000000000000001
10100101101000010101
10100C000000000110C1
10C00101001000101011
10000101001C00010001
11111111111111111111