1111111111111111111111111111111111
1E000P0000000001000001000000000001
1010010100100010100100000000010101
1010101001000010100100000000010101
1010010100100001101100000000010101
1010010100100010100100000000010101
1010010110100001010010100000010101
1010010000100001101100011000010101
1010010100101110101001000000010101
1010100001000001010010000010010101
10100101001100011001001110000101C1
1111111111111111111111111111111111