1111111111111111111111111111111111
1E000P000000000100000100C000000001
101001010010CCC010100100C000010101
101CC101001CC000101001000000010101
10100101001000011C1100000000C10101
1111111111111111111111111111111111