111111111111111111111111111111111111111111111111111
111000000000000000000000000000000000000000000000001
10000000000000000000000000000000000000BB00000000101
1000000000000000111000000000000000000BBBBBB000001C1
100000000000001111110001110000000000000BBB000001111
1000000000000111111E0011111000000000000000000000011
10000000000000111100C111111100000000000000000000101
100000000000001110001111111100000000000000000000011
111100000000011111111111111111000000000000000000101
100000000000001111111111111110000000000000000000001
100000000000000111111111111100P00000000000000001111
110000000000000011111111111000000000000000000000001
100000000000000001111111110000000000000000000000011
100000000000000000000000000000000000000000010000001
100000000000000000000000000000000000000001100000001
100000000000000000000000000000000000000000100000001
1000000000000000000000000000CC000000000000000000101
100111000000000000000000000000000000000000000000011
11111C001111100000000000000000000000000000000000011
111111111111110000000000000000000000000000000000101
1CC111111111000B00000000000000000000000000000011011
1000000000000BBBB0000000000000000000000000001111111
100000000000BBBBBB0000000000000000000111111011C1111
100C000000000BBBB000000000000000000000001110C001101
1000000000000BB000000000000000000000000000111111111
111111111111111111111111111111111111111111111111111