1111111111111111111111111111111111111111111111111111
1000000000000000000000000000000000000000000000000011
10000000000000000000000000000000000000BB000000001011
1000000000000000111000000000000000000BBBBBB000001C11
100000000000001111110001110000000000000BBB0000011111
1000000000000111111E00111110000000000000000000000111
10000000000000111100C1111111000000000000000000001011
1000000000000011100011111111000000000000000000000111
1000000000000111111111111111110000000000000000001011
1000000000000011111111111111100000000000000000000011
100000000000000111111111111100P000000000000000000011
1000000000000000111111111110000000000000000000000011
1000000000000000011111111100000000000000000000000011
1000000000000000000000000000000000000000000000000011
1000000000000000000000000000000000000000000000000011
1000000000000000000000000000000000000000000000000011
1000000000000000000000000000CC0000000000000000001011
1001110000000000000000000000000000000000000000000111
11111C0011111000000000000000000000000000000000000111
1111111111111100000000000000000000000000000000001011
1CC111111111000B000000000000000000000000000000110111
1000000000000BBBB00000000000000000000000000011111111
100000000000BBBBBB0000000000000000000111111011C11111
100C000000000BBBB000000000000000000000001110C1111011
1000000000000BB0000000000000000000000000001111111111
1000001111111111000000000000000000000001111111111111
1111111111111111000000001111111111111111111111111111
1111111111111111111111111111111111111111111111111111