1111111111111111
1P00000P01000001
1000E00000B10100
10000E0010000001
1000000000000001
1111111111111111